00000000000000000000000000000
00022002222000000000000000000
22000000000000000220000000000
11222222222222222110000000000
11111111111111111110000022202
11111111111111111110000211101
11111111111111111110002111101
11111111111111111110021111101
11111111111111111112211111111
11111111111111111111111111111
11111111111111111111111111111
